trial_lvl
An Interactive Fiction by Johanna Rossoll & Axel Dultinger
Release 1 / Serial number 240401 / Inform 7 v10.1.2 / D

Living Room
A dusty old living room. Bottles and cans are scattered across tables and the floor. It is boiling hot! Maybe you should open a window.

You can see Anne here.

>examine anne
Anne is blonde and tall. She has been your best friend since elementary school.

>open window
Ah the cool night air!

You open Window.

>say can i have a beer? to anne
There is no reply.

>say can i have a drink to anne
There is no reply.

>say drinks to anne
There is no reply.

* * *

trial_lvl
An Interactive Fiction by Johanna Rossoll & Axel Dultinger
Release 1 / Serial number 240401 / Inform 7 v10.1.2 / D

Living Room
A dusty old living room. Bottles and cans are scattered across tables and the floor. It is boiling hot! Maybe you should open a window.

You can see Anne here.

>say beer to anne
There is no reply.

* * *

trial_lvl
An Interactive Fiction by Johanna Rossoll & Axel Dultinger
Release 1 / Serial number 240401 / Inform 7 v10.1.2 / D

Living Room
A dusty old living room. Bottles and cans are scattered across tables and the floor. It is boiling hot! Maybe you should open a window.

You can see Anne here.

>say drinks to anne
There is no reply.

* * *

trial_lvl
An Interactive Fiction by Johanna Rossoll & Axel Dultinger
Release 1 / Serial number 240401 / Inform 7 v10.1.2 / D

Living Room
A dusty old living room. Bottles and cans are scattered across tables and the floor. It is boiling hot! Maybe you should open a window.

You can see Anne here.

>open window
Ah the cool night air!

You open Window.

>say  i want drinks
(to Anne)
There is no reply.

* * *

>open window
Ah the cool night air!

You open Window.

>close window
You close Window.

>go to the kitchen
You can't see any such thing.

>go south
Kitchen
A kitchen, which would have looked nice if it weren't for the mountain of dishes in the sink and the various unidentifiable stains everywhere. It smells like someone burnt something

You can see toaster (in which is a burnt toast) here.

>eat toast
(first taking the burnt toast)
You eat the burnt toast. Not bad.

>spitting out the toast
That's not a verb I recognise.

>make another toast
That's not a verb I recognise.

>exit the kitchen
I only understood you as far as wanting to exit.

* * *

trial_lvl
An Interactive Fiction by Johanna Rossoll & Axel Dultinger
Release 1 / Serial number 240401 / Inform 7 v10.1.2 / D

Living Room
A dusty old living room. Bottles and cans are scattered across tables and the floor. It is boiling hot! Maybe you should open a window.

You can see Anne here.

>say drinks to Anne
There is no reply.

>say  you have a beer to anne?
You can't see any such thing.

>say  you have a beer to anne
There is no reply.

>say hello to anne
There is no reply.

>say beer to anne
There is no reply.

>ask anne about beer
There is no reply.

>ask for beer
You can't see any such thing.

>veer
That's not a verb I recognise.

>beer
That's not a verb I recognise.

* * *

trial_lvl
An Interactive Fiction by Johanna Rossoll & Axel Dultinger
Release 1 / Serial number 240401 / Inform 7 v10.1.2 / D

Living Room
A dusty old living room. Bottles and cans are scattered across tables and the floor. It is boiling hot! Maybe you should open a window.

You can see Anne here.

>ask anne for beer
Anne has better things to do.

>ask anne about beer
There is no reply.

>tell anne to give me beer
I didn't understand that sentence.

>give me beer
(first taking the beer)
That seems to belong to Anne.

* * *

>ask anne for beer
Anne has better things to do.

>say do you have beer? to anne
There is no reply.

>ask anne for drinks
Anne says, "Sorry, I don't have any beer." 
Anne says, "Sorry, I don't have any beer."

* * *

>ask anne for beer
Anne has better things to do.

>ask anne for drinks
Anne offers you a beer.

>take beer
You have the beer now.

* * *

trial_lvl
An Interactive Fiction by Johanna Rossoll & Axel Dultinger
Release 1 / Serial number 240401 / Inform 7 v10.1.2 / D

Living Room
A dusty old living room. Bottles and cans are scattered across tables and the floor. It is boiling hot! Maybe you should open a window.

You can see Anne here.

>ask for drinks
You can't see any such thing.

>ask anne for drinks
Anne says, "Hey, want a beer?"

>yes
That was a rhetorical question.

>sorry
Oh, don't apologise.

>ask anne for drinks
Anne says, "Hey, want a beer?"

>ask anne for beer
Anne offers you a beer.

* * *

trial_lvl
An Interactive Fiction by Johanna Rossoll & Axel Dultinger
Release 1 / Serial number 240401 / Inform 7 v10.1.2 / D

Living Room
A dusty old living room. Bottles and cans are scattered across tables and the floor. It is boiling hot! Maybe you should open a window.

You can see Anne here.

>ask anne for drinks
Anne offers you a beer.

* * *

trial_lvl
An Interactive Fiction by Johanna Rossoll & Axel Dultinger
Release 1 / Serial number 240401 / Inform 7 v10.1.2 / D

Living Room
A dusty old living room. Bottles and cans are scattered across tables and the floor. It is boiling hot! Maybe you should open a window.

You can see Anne here.

>hi anne
That's not a verb I recognise.

>ask anne for drinks
Anne says, "Hey, want a beer?"

>take beer
You have the beer now.

>Give me beer
You can't give the beer to yourself.

>say do you have beer
(to Anne)
There is no reply.

>ask anne for beer
(Anne first taking the beer)
Anne has better things to do.

>ask anne for drinks
Anne says, "Sorry, I don't have any beer." 
Anne says, "Sorry, I don't have any beer."