trial_lvl
An Interactive Fiction by Johanna Rossoll & Axel Dultinger
Release 1 / Serial number 240330 / Inform 7 v10.1.2 / D

Living Room
A dusty old living room. Bottles and cans are scattered across tables and the floor. It is boiling hot! Maybe you should open a window.

You can see Anne here.

>ask anne about drinks
Anne says, "Hey, want a beer?"

>g
Anne says, "Hey, want a beer?"

>g
Anne says, "Hey, want a beer?"

>look
Living Room
A dusty old living room. Bottles and cans are scattered across tables and the floor. It is boiling hot! Maybe you should open a window.

You can see Anne here.

>examine beer
A bottle of beer. It's cold and refreshing.

>examine anne
Anne is blonde and tall. She has been your best friend since elementary school.

>take beer
That seems to belong to Anne.

* * *

>ask anne about drinks
Anne says, "Hey, want a beer?"

>i
You are carrying nothing.

>ask anne about drinks
Anne says, "Hey, want a beer?"

* * *

trial_lvl
An Interactive Fiction by Johanna Rossoll & Axel Dultinger
Release 1 / Serial number 240330 / Inform 7 v10.1.2 / D

Living Room
A dusty old living room. Bottles and cans are scattered across tables and the floor. It is boiling hot! Maybe you should open a window.

You can see Anne here.

>examine Anne
Anne is blonde and tall. She has been your best friend since elementary school.

>say Hello to Anne
She says: "Hey, want a beer?" as she hands it to you.

>take bottle of beer
You take the bottle of beer from Anne's hand. She smiles as you accept her offer walks away to your other friends.

>enter balcony
You can't see any such thing.

* * *

trial_lvl
An Interactive Fiction by Johanna Rossoll & Axel Dultinger
Release 1 / Serial number 240330 / Inform 7 v10.1.2 / D

Living Room
A dusty old living room. Bottles and cans are scattered across tables and the floor. It is boiling hot! Maybe you should open a window.

You can see Anne here.

>examine anne
Anne is blonde and tall. She has been your best friend since elementary school.

>talk to anne
That's not a verb I recognise.

>say
I didn't understand that sentence.

>say hi anne
(to Anne)
There is no reply.

* * *

trial_lvl
An Interactive Fiction by Johanna Rossoll & Axel Dultinger
Release 1 / Serial number 240330 / Inform 7 v10.1.2 / D

Living Room
A dusty old living room. Bottles and cans are scattered across tables and the floor. It is boiling hot! Maybe you should open a window.

You can see Anne here.

>examine bottle of beer
A bottle of beer. It's cold and refreshing.

* * *

trial_lvl
An Interactive Fiction by Johanna Rossoll & Axel Dultinger
Release 1 / Serial number 240330 / Inform 7 v10.1.2 / D

Living Room
A dusty old living room. Bottles and cans are scattered across tables and the floor. It is boiling hot! Maybe you should open a window.

You can see Anne here.

>examine room
You can't see any such thing.

* * *

trial_lvl
An Interactive Fiction by Johanna Rossoll & Axel Dultinger
Release 1 / Serial number 240330 / Inform 7 v10.1.2 / D

Living Room
A dusty old living room. Bottles and cans are scattered across tables and the floor. It is boiling hot! Maybe you should open a window.

You can see Anne here.

>g
You can hardly repeat that.

>t
That's not a verb I recognise.

>ask anne about drinks
There is no reply.

>g
There is no reply.

* * *

trial_lvl
An Interactive Fiction by Johanna Rossoll & Axel Dultinger
Release 1 / Serial number 240330 / Inform 7 v10.1.2 / D

Living Room
A dusty old living room. Bottles and cans are scattered across tables and the floor. It is boiling hot! Maybe you should open a window.

You can see Anne here.

>greet Anne
That's not a verb I recognise.

* * *

trial_lvl
An Interactive Fiction by Johanna Rossoll & Axel Dultinger
Release 1 / Serial number 240330 / Inform 7 v10.1.2 / D

Living Room
A dusty old living room. Bottles and cans are scattered across tables and the floor. It is boiling hot! Maybe you should open a window.

You can see Anne here.

>greet anne
That's not a verb I recognise.

>say hello to anne
There is no reply.

* * *

trial_lvl
An Interactive Fiction by Johanna Rossoll & Axel Dultinger
Release 1 / Serial number 240330 / Inform 7 v10.1.2 / D

Living Room
A dusty old living room. Bottles and cans are scattered across tables and the floor. It is boiling hot! Maybe you should open a window.

You can see Anne here.

>hi anne
That's not a verb I recognise.

>accept drink
That's not a verb I recognise.

>accept bottle of beer
That's not a verb I recognise.

>take bottle of beer
That seems to belong to Anne.

>accept
That's not a verb I recognise.

>accept beer
That's not a verb I recognise.

>greet anne
That's not a verb I recognise.

* * *

trial_lvl
An Interactive Fiction by Johanna Rossoll & Axel Dultinger
Release 1 / Serial number 240330 / Inform 7 v10.1.2 / D

Living Room
A dusty old living room. Bottles and cans are scattered across tables and the floor. It is boiling hot! Maybe you should open a window.

You can see Anne here.

>look
Living Room
A dusty old living room. Bottles and cans are scattered across tables and the floor. It is boiling hot! Maybe you should open a window.

You can see Anne here.

>open window
You open Window.

>n
Balcony
You step outside onto the balcony. The cool night air hits your face, providing some relief from the heat inside.

>s
Living Room
A dusty old living room. Bottles and cans are scattered across tables and the floor. It is boiling hot! Maybe you should open a window.

You can see Anne here.

>close window
You close Window.

>n
(first opening Window)

Balcony
You step outside onto the balcony. The cool night air hits your face, providing some relief from the heat inside.

* * *

>look
Living Room
A dusty old living room. Bottles and cans are scattered across tables and the floor. It is boiling hot! Maybe you should open a window.

You can see Anne here.

>say hi to anne
There is no reply.

>say hello to anne
She says: "Hey, want a beer?" as she hands it to you.

>take beer
You take the bottle of beer from Anne's hand. She smiles as you accept her offer walks away to your other friends.

That seems to belong to Anne.

>i
You are carrying nothing.

* * *

trial_lvl
An Interactive Fiction by Johanna Rossoll & Axel Dultinger
Release 1 / Serial number 240330 / Inform 7 v10.1.2 / D

Living Room
A dusty old living room. Bottles and cans are scattered across tables and the floor. It is boiling hot! Maybe you should open a window.

You can see Anne here.

>look around
You can't see any such thing.

>examine room
You can't see any such thing.

* * *

trial_lvl
An Interactive Fiction by Johanna Rossoll & Axel Dultinger
Release 1 / Serial number 240330 / Inform 7 v10.1.2 / D

Living Room
A dusty old living room. Bottles and cans are scattered across tables and the floor. It is boiling hot! Maybe you should open a window.

You can see Anne here.

>look at bottles
Empty beer cans, liquor bottles and cups are at everywhere. They are sticky and they stink of alcohol.

>take bottles
Taken.

>who
That's not a verb I recognise.

* * *

trial_lvl
An Interactive Fiction by Johanna Rossoll & Axel Dultinger
Release 1 / Serial number 240330 / Inform 7 v10.1.2 / D

Living Room
A dusty old living room. Bottles and cans are scattered across tables and the floor. It is boiling hot! Maybe you should open a window.

You can see Anne here.

>n
(first opening Window)

Balcony
You step outside onto the balcony. The cool night air hits your face, providing some relief from the heat inside.

You can see Window here.

>s
Living Room
A dusty old living room. Bottles and cans are scattered across tables and the floor. It is boiling hot! Maybe you should open a window.

You can see Anne here.

>use window
That's not a verb I recognise.

>open window
That's already open.

* * *

trial_lvl
An Interactive Fiction by Johanna Rossoll & Axel Dultinger
Release 1 / Serial number 240330 / Inform 7 v10.1.2 / D

Living Room
A dusty old living room. Bottles and cans are scattered across tables and the floor. It is boiling hot! Maybe you should open a window.

You can see Anne here.

>open window
Ah the cool night air!

You open Window.

>inspect window
That's not a verb I recognise.

>examine windo
You can't see any such thing.

>examine window
A big closed window.

>open window
That's already open.

>n
Balcony
You step outside onto the balcony. The cool night air hits your face, providing some relief from the heat inside.

>open window
That's already open.

>close window
You close Window.

* * *

I beg your pardon?

>open window
That's already open.

* * *

>close window
You close Window.

>opening window
That's not a verb I recognise.

>opening window
That's not a verb I recognise.

>s
(first opening Window)

Living Room
A dusty old living room. Bottles and cans are scattered across tables and the floor. It is boiling hot! Maybe you should open a window.

You can see Anne here.

>opening window
That's not a verb I recognise.

>talk anne
That's not a verb I recognise.

>anne
That's not a verb I recognise.

>examine anne
Anne is blonde and tall. She has been your best friend since elementary school.

>talk anne
That's not a verb I recognise.

>talk with anne
That's not a verb I recognise.

>say hello
(to Anne)
She says: "Hey, want a beer?" as she hands it to you.

>examine beer
A bottle of beer. It's cold and refreshing.

>take beer
You take the bottle of beer from Anne's hand. She smiles as you accept her offer walks away to your other friends.

>i
You are carrying nothing.

* * *

>open window
Ah the cool night air!

You open Window.

>open window
That's already open.

* * *

>n
Balcony
You step outside onto the balcony. The cool night air hits your face, providing some relief from the heat inside.

* * *

>open window
Ah the cool night air!

You open Window.

>say hello to anne
She says: "Hey, want a beer?" as she hands it to you.

>take beer
You take the bottle of beer from Anne's hand. She smiles as you accept her offer walks away to your other friends.

* * *

trial_lvl
An Interactive Fiction by Johanna Rossoll & Axel Dultinger
Release 1 / Serial number 240330 / Inform 7 v10.1.2 / D

Living Room
A dusty old living room. Bottles and cans are scattered across tables and the floor. It is boiling hot! Maybe you should open a window.

You can see Anne here.

>s
Kitchen
A kitchen, which would have looked nice if it weren't for the mountain of dishes in the sink and the various unidentifiable stains everywhere. It smells like someone burnt something

You can see toaster (in which is a burnt toast) here.

>open toaster
You can't see any such thing.

* * *

>s
Kitchen
A kitchen, which would have looked nice if it weren't for the mountain of dishes in the sink and the various unidentifiable stains everywhere. It smells like someone burnt something

You can see toaster (in which is a burnt toast) here.

>take burnt toast
Taken.

>examine toast
You see nothing special about the burnt toast.

>eat toast
You eat the burnt toast. Not bad.

>i
You are carrying nothing.

>look
Kitchen
A kitchen, which would have looked nice if it weren't for the mountain of dishes in the sink and the various unidentifiable stains everywhere. It smells like someone burnt something

You can see toaster (empty) here.

* * *

trial_lvl
An Interactive Fiction by Johanna Rossoll & Axel Dultinger
Release 1 / Serial number 240330 / Inform 7 v10.1.2 / D

Living Room
A dusty old living room. Bottles and cans are scattered across tables and the floor. It is boiling hot! Maybe you should open a window.

You can see Anne here.

>say Hello to Anne
Hey, want a beer?

* * *

trial_lvl
An Interactive Fiction by Johanna Rossoll & Axel Dultinger
Release 1 / Serial number 240330 / Inform 7 v10.1.2 / D

Living Room
A dusty old living room. Bottles and cans are scattered across tables and the floor. It is boiling hot! Maybe you should open a window.

You can see Anne here.

>take bottle of beer
You take the bottle of beer from Anne's hand. She doesn't seem to mind.

>examine bottle of beer
A bottle of beer. It's cold and refreshing.

* * *

trial_lvl
An Interactive Fiction by Johanna Rossoll & Axel Dultinger
Release 1 / Serial number 240330 / Inform 7 v10.1.2 / D

Living Room
A dusty old living room. Bottles and cans are scattered across tables and the floor. It is boiling hot! Maybe you should open a window.

You can see Anne here.

>talk anne
That's not a verb I recognise.

>say hi to anne
There is no reply.

* * *

>take beer
You take the bottle of beer from Anne's hand. She smiles as you accept her offer walks away to your other friends.

>take beer
You take the bottle of beer from Anne's hand. She smiles as you accept her offer walks away to your other friends.

* * *

trial_lvl
An Interactive Fiction by Johanna Rossoll & Axel Dultinger
Release 1 / Serial number 240330 / Inform 7 v10.1.2 / D

Living Room
A dusty old living room. Bottles and cans are scattered across tables and the floor. It is boiling hot! Maybe you should open a window.

You can see Anne here.

>talk with anne
That's not a verb I recognise.

>anne
That's not a verb I recognise.

>say hello
(to Anne)
There is no reply.

>say greeting
(to Anne)
There is no reply.

>greeting
That's not a verb I recognise.

>say beer
(to Anne)
There is no reply.

>ask anne about greeting
There is no reply.