Welcome to the tutorial! Let's start by teaching you some basic commands. You can examine the area around you by typing "examine xyz". You can use "talk to *someone*" to trigger interactions, and you can type "leave party" at any time to end the game. Type "i" or "inv" at any point of the game, to see your inventory. If you want to skip the Tutorial, because you are familiar with Interactive Fiction, simply type "yes" to dive right into the story!

Welcome
An Interactive Fiction
Release 1 / Serial number 240621 / Inform 7 v10.1.2 / D

Bathroom
The bathroom looks very clean and fresh compared to the rest of the house. There's a sink, a bathroom mirror, a cabinet, and a towel holder here. You also see your friend Anna. You can get into action and try "take towel".

You can see a sink (on which is a soap bar), a bathroom mirror, a cabinet (closed), a holder (on which is a towel), a faucet and Anna here.

>yes
Congratulations! You've completed the tutorial. Enjoy the rest of the party!

Street
Your dad drove you to a party some friends at school invited you to. You weren't sure if you should go, but they said you'll have a lot of fun.
 
You just exited the car and convinced him not to escort you to the front door of the house, as you hear him roll down the window of his car: "Be careful, dear. And remember what we talked about - do not drink any alcohol and absolutely no drugs!
Other then your dad there is no one outside and you can already hear the music coming from the light up house.

You can see front door, Porch light, Pathway, Car (in which is Dad) and Potted Tree here.

>go north
(first opening front door)

Hall
As you enter the hallway, you are greeted by a friend of yours, Jasmine. She's a year older than you - a plump, dark haired girl with blue eyes. She greets you with a happy expression: "You made it! To be honest, I didn't expect to see you here today. Glad you're here!" The hall is a cozy room, with warm tapestry and you hear loud sounds, music from one of the other rooms.

You can see front door, Stairs, mirror, Chandelier, Coat Rack, Shelve (empty), Pictures, Shoe Rack and Jasmine here.

>go down
(first opening Stairs)
In the midst of all the people dancing and singing, you see a tall guy with a buzzcut - he introduces himself as "Clip". He holds out his hand and reveals a small square of paper. He extends it towards you. With a grin he says: "This will change your life." Your decision hangs in the balance - to take or reject?

Basement
You descend into the basement, where the thumping bass of the music becomes almost tangible, pulsating through the air. The room is alive with movement, bodies swaying to the rhythm in the dimly lit space.

You can see Stairs, Couch, Boom Box, Old Rug and Clip here.

>examine clip
A twenty year old man with a blonde buzz cut and bright green eyes. He smells of cigarettes and energy drinks. He smiles back at you as you look at him.

>take blotter paper
That seems to belong to Clip.

>take blotter paper from clip
That seems to belong to Clip.

* * *

>greet clip
That's not a verb I recognise.

>talk to clip
Clip doesn't reply.

>accept blotter paper
That's not a verb I recognise.

>take blotter paper
You put the paper under your tongue as instructed by Clip. After a short period of time, reality warps around you, colors bleeding into one another, and the music morphing into a symphony of chaos. It's a journey into the recesses of your mind, but one fraught with peril: Colors pulsate with an overwhelming intensity, morphing into surreal shapes that dance before your disbelieving eyes. Every sound becomes a discordant chaotic noise, echoing endlessly. Paranoia grips your thoughts, the shadows seem to be attacking you from everywhere, they flicker and dance, morphing into grotesque forms that seem to mock your terror. You fall unconscious.

    *** You have fallen unconscious. ***

Would you like to RESTART, RESTORE a saved game, QUIT or UNDO the last command?

>undo
Basement
[Previous turn undone.]

>reject blotter paper
You hang out with Clip for a while but he seems a bit zoned out after a while. It's as if he's been plunged into a nightmare. Suddenly, his eyes widen with fear making you uncomfortable. You want to stand up and leave but your mind in empathy for Clip is shouting: "What is happening?!" His eyes are now darting frantically around the room as if searching for escape from unseen terrors. He jumps up from the couch, jerky and erratic. What do you do, leave or help?

>help clip
You drag Clip to the garden to get a calmer and more quiet environment for him. You sit him down on the floor and reassure him that everything is going to be fine. You try calming him down by doing some breathing exercises and bringing him a glass of water from the kitchen. It helps him a lot.

Garden
Ah. The cool night air! You open the door to the garden and see a big pool with LEDs and some people in and around it, although it is quite cold for August.

You can see Clip here.

* * *

>open front door
You open front door.

>enter house
You can't see any such thing.

>enter front door
Hall
As you enter the hallway, you are greeted by a friend of yours, Jasmine. She's a year older than you - a plump, dark haired girl with blue eyes. She greets you with a happy expression: "You made it! To be honest, I didn't expect to see you here today. Glad you're here!" The hall is a cozy room, with warm tapestry and you hear loud sounds, music from one of the other rooms.

You can see front door, Stairs, mirror, Chandelier, Coat Rack, Shelve (empty), Pictures, Shoe Rack and Jasmine here.

>talk to jasmine
Jasmine: Hi! You finally showed up. I was starting to think that you're going to ditch me here like you always do.

Me:  Hello to you too, and what do you mean, like I always do? This is the only time I agreed to come to one of these parties. Remember?

Jasmine: Alright, alright, I'm too good for the crowd, let's take your coat off and go inside.

Me:  From the smell of alcohol, I can already tell I'm going to like it.

Jasmine: Oh, that's right. You've never been drunk. Maybe we can change your mind tonight.

Jasmine: And, by the way, you know who is here. Maybe she/he can help you loosen up tonight

Me:  Can we not talk about her/him right now?

Jasmine: Okay, but promise me you are going to do something about it tonight

Me:  I promise!

>look into mirror
You find nothing of interest.

>look at pictures
A collection of family pictures lines the walls, capturing what seems to be a ski vacation of Jasmine and her family. It makes you think that she seems a lot more mature now.

>look at chandelier
A vintage chandelier hangs from the ceiling, casting a soft, warm glow over the hallway. It wiggles a bit with the beat of the music from another room.

>go down stairs
I only understood you as far as wanting to go down.

>go down
(first opening Stairs)

Basement
You descend into the basement, where the thumping bass of the music becomes almost tangible, pulsating through the air. The room is alive with movement, bodies swaying to the rhythm in the dimly lit space.

You can see Stairs, Couch, Boom Box, Old Rug and Clip here.

In the midst of all the people dancing and singing, you see a tall guy with a buzzcut - he introduces himself as "Clip". He holds out his hand and reveals a small square of paper. He extends it towards you. With a grin he says: "This will change your life." Your decision hangs in the balance - to take or reject?

>look at clip
A twenty year old man with a blonde buzz cut and bright green eyes. He smells of cigarettes and energy drinks. He smiles back at you as you look at him.

>take
What do you want to take?

>take paper
You put the paper under your tongue as instructed by Clip. After a short period of time, reality warps around you, colors bleeding into one another, and the music morphing into a symphony of chaos. It's a journey into the recesses of your mind, but one fraught with peril: Colors pulsate with an overwhelming intensity, morphing into surreal shapes that dance before your disbelieving eyes. Every sound becomes a discordant chaotic noise, echoing endlessly. Paranoia grips your thoughts, the shadows seem to be attacking you from everywhere, they flicker and dance, morphing into grotesque forms that seem to mock your terror. You fall unconscious.

    *** You have fallen unconscious. ***

Would you like to RESTART, RESTORE a saved game, QUIT or UNDO the last command?

>undo
Basement
[Previous turn undone.]

>reject paper
You hang out with Clip for a while but he seems a bit zoned out after a while. It's as if he's been plunged into a nightmare. Suddenly, his eyes widen with fear making you uncomfortable. You want to stand up and leave but your mind in empathy for Clip is shouting: "What is happening?!" His eyes are now darting frantically around the room as if searching for escape from unseen terrors. He jumps up from the couch, jerky and erratic. What do you do, leave or help?

>help clip
You drag Clip to the garden to get a calmer and more quiet environment for him. You sit him down on the floor and reassure him that everything is going to be fine. You try calming him down by doing some breathing exercises and bringing him a glass of water from the kitchen. It helps him a lot. He should be safe here now. You can leave him with all your friends up here.

Garden
Ah. The cool night air! You open the door to the garden and see a big pool with LEDs and some people in and around it, although it is quite cold for August.

You can see Clip here.

>talk to clip
Clip doesn't reply.

* * *

>go home
You decide it's time to leave the party.
As you say goodbye to your host and others, a friend comes over and asks to walk home with you. "The party was a bit much, and I'm glad you're strong enough to not get pressured into anything stupid," they say.

    *** You walk home safely with your friend, feeling good about your choices. ***

Would you like to RESTART, RESTORE a saved game, QUIT or UNDO the last command?

>quit
[ The game has finished ]