Welcome to the tutorial! Let's start by teaching you some basic commands. You can examine the area around you by typing "examine xyz". You can use "talk to *someone*" to trigger interactions, and you can type "leave party" at any time to end the game. Type "i" or "inv" at any point of the game, to see your inventory. If you want to skip the Tutorial, because you are familiar with Interactive Fiction, simply type "yes" to dive right into the story!

Welcome
An Interactive Fiction
Release 1 / Serial number 240701 / Inform 7 v10.1.2 / D

Bathroom
The bathroom looks very clean and fresh compared to the rest of the house. There's a sink, a bathroom mirror, a cabinet, and a towel holder here. You also see your friend Anna. You can get into action and try "take towel".

You can see a sink (on which is a soap bar), a bathroom mirror, a cabinet (closed), a holder (on which is a towel), a faucet and Anna here.

>take towel
Good job! Now, type "drop towel" to put it down.

>i
You are carrying:
  a towel

>drop towel
Great! Now, let's put it on the towel holder. Type "put towel on holder".

>i
You are carrying nothing.

>put towel on holder
(first taking the towel)
Well done! Now, let's interact with something else. Type "eat soap".

>eat soap
That doesn't taste good, does it? Now, let's move around. Type "go northwest" to leave the bathroom.

>go northwest
You are now in the hallway. Let's go back to the bathroom by typing "go southeast".

>go southeast
You're back in the bathroom. Type "enter cabinet".

>enter cabinet
The cabinet is too small to enter. Let's examine the bathroom mirror. Type "examine bathroom mirror".

>examine bathroom mirror
A large mirror reflecting the room.

Nice! Now, let's open the cabinet. Type "open cabinet".

>open cabinet
Fantastic! Now, let's switch something on. Type "switch on faucet".

>switch on faucet
You turn the faucet on, and water starts flowing. Now, let's switch it off. Type "switch off faucet".

>switch off faucet
You turn the faucet off, and water stops flowing. Try closing the cabinet.

>close cabinet
Great! Now, let's practice giving something. Take the key from the cabinet (you have to open it again) and type "give key to Anna".

>take key
You can't see any such thing.

>open cabinet
You open the cabinet, revealing a key.

>take key
Taken.

>give key to ana
You can't see any such thing.

>giv ekey to anna
That's not a verb I recognise.

>give key to anna
Nice work! Now, let's ask Anna for something. Type "ask Anna for towel".

>ask anna for towel
Anna says: "Here you go!" and hands you a towel.

Good job! Now, let's touch something. Type "touch sink".

>touch sink
The sink feels cold and smooth.

Great! Finally, let's say something. Type "yes".

>yes
Congratulations! You've completed the tutorial. Enjoy the rest of the party!

Street
Your dad drove you to a party some friends at school invited you to. You weren't sure if you should go, but they said you'll have a lot of fun.
 
You just exited the car and convinced him not to escort you to the front door of the house, as you hear him roll down the window of his car: "Be careful, dear. And remember what we talked about - do not drink any alcohol and absolutely no drugs!
Other then your dad there is no one outside and you can already hear the music coming from the light up house.

You can see front door, Porch light, Pathway, Car (in which is Dad) and Potted Tree here.

>go north
(first opening front door)

Hall
As you enter the hallway, you are greeted by a friend of yours, Jasmine. She's a year older than you - a plump, dark haired girl with blue eyes. She greets you with a happy expression: "You made it! To be honest, I didn't expect to see you here today. Glad you're here!" The hall is a cozy room, with warm tapestry and you hear loud sounds, music from one of the other rooms.

You can see front door, Stairs, mirror, Chandelier, Coat Rack, Shelve (empty), Pictures, Shoe Rack and Jasmine here.

>talk to jasmine
Jasmine: Hi! You finally showed up. I was starting to think that you're going to ditch me here like you always do.

Me:  Hello to you too, and what do you mean, like I always do? This is the only time I agreed to come to one of these parties. Remember?

Jasmine: Alright, alright, I'm too good for the crowd, let's take your coat off and go inside.

Me:  From the smell of alcohol, I can already tell I'm going to like it.

Jasmine: Oh, that's right. You've never been drunk. Maybe we can change your mind tonight.

Jasmine: And, by the way, you know who is here. Maybe she/he can help you loosen up tonight

Me:  Can we not talk about her/him right now?

Jasmine: Okay, but promise me you are going to do something about it tonight

Me:  I promise!

* * *

>yes
Congratulations! You've completed the tutorial. Enjoy the rest of the party!

Street
Your dad drove you to a party some friends at school invited you to. You weren't sure if you should go, but they said you'll have a lot of fun.
 
You just exited the car and convinced him not to escort you to the front door of the house, as you hear him roll down the window of his car: "Be careful, dear. And remember what we talked about - do not drink any alcohol and absolutely no drugs!
Other then your dad there is no one outside and you can already hear the music coming from the light up house.

You can see front door, Porch light, Pathway, Car (in which is Dad) and Potted Tree here.